communityName,Type,BfZ,KP,all2019,ind2019,sheltInd2019,unsheltInd2019,chind2019
"Akron, Barberton/Summit County CoC",Largely Suburban CoC,,,546,425,338,87,54
Alabama Balance of State CoC,Largely Rural CoC,,,323,218,89,129,16
Alaska Balance of State CoC,Largely Rural CoC,,,796,585,416,169,152
Albany City & County CoC,Largely Suburban CoC,,,750,543,509,34,91
Albuquerque CoC,Major City CoC,x,,1524,1224,677,547,564
Alexandria CoC,Other Largely Urban CoC,,,198,124,114,10,38
Alexandria/Central Louisiana CoC,Largely Rural CoC,,,114,87,68,19,21
"Alpine, Inyo, Mono Counties CoC",Largely Rural CoC,,,214,198,9,189,79
"Amador, Calaveras, Mariposa, Tuolumne Counties CoC",Largely Rural CoC,,,845,663,56,607,227
Amarillo CoC,Other Largely Urban CoC,,,777,627,296,331,265
Anchorage CoC,Other Largely Urban CoC,x,,1111,799,702,97,79
Annapolis/Anne Arundel County CoC,Largely Suburban CoC,,,302,225,166,59,71
Appalachian Regional CoC,Largely Rural CoC,,,405,294,156,138,51
Arizona Balance of State CoC,Largely Rural CoC,,,2021,1575,682,893,515
Arkansas  Balance of State  CoC,Largely Rural CoC,,,811,736,232,504,169
Arlington County CoC,Other Largely Urban CoC,x,x,215,149,113,36,74
Asheville/Buncombe County CoC,Largely Suburban CoC,,,580,539,467,72,121
Athens-Clarke County CoC,Other Largely Urban CoC,,,237,161,106,55,36
Atlanta CoC,Major City CoC,x,x,3217,2718,2001,717,364
Atlantic City & County CoC,Largely Suburban CoC,,,357,328,232,96,60
"Attleboro, Taunton/Bristol County CoC",Largely Suburban CoC,,,256,72,38,34,14
Augusta-Richmond County CoC,Other Largely Urban CoC,,,384,312,167,145,33
"Aurora, Elgin/Kane County CoC",Largely Suburban CoC,,,388,335,290,45,126
Austin/Travis County CoC,Major City CoC,,,2255,1701,628,1073,587
Bakersfield/Kern County CoC,Other Largely Urban CoC,x,x,1330,1118,348,770,64
Baltimore City CoC,Major City CoC,x,x,2294,1944,1573,371,579
Baltimore County CoC,Largely Suburban CoC,,,735,438,232,206,141
Battle Creek/Calhoun County CoC,Other Largely Urban CoC,,,241,162,126,36,31
Beaver County CoC,Largely Suburban CoC,,,123,52,46,6,0
Bergen County CoC,Largely Suburban CoC,x,,271,177,173,4,11
"Binghamton, Union Town/Broome, Otsego, Chenango, Delaware, Cortland, Tioga Count",Largely Rural CoC,,,318,255,246,9,0
"Birmingham/Jefferson, St. Clair, Shelby Counties CoC",Largely Suburban CoC,,,981,805,495,310,97
Bloomington/Central Illinois CoC,Largely Rural CoC,,,319,223,168,55,44
Boise/Ada County CoC,Other Largely Urban CoC,,,713,568,507,61,186
Boston CoC,Major City CoC,,,6242,2392,2271,121,508
"Bridgeport, Stamford, Norwalk, Danbury/Fairfield County CoC",Other Largely Urban CoC,,,771,474,378,96,56
"Bristol, Bensalem/Bucks County CoC",Largely Suburban CoC,,,359,156,135,21,30
"Bryan, College Station/Brazos Valley CoC",Other Largely Urban CoC,,,123,92,74,18,16
"Buffalo, Niagara Falls/Erie, Niagara, Orleans, Genesee, Wyoming Counties CoC",Largely Suburban CoC,,,924,551,518,33,31
Burlington County CoC,Largely Suburban CoC,,,518,239,216,23,18
Burlington/Chittenden County CoC,Other Largely Urban CoC,x,,309,228,180,48,58
Cambridge CoC,Other Largely Urban CoC,,,555,384,326,58,209
"Camden City & County/Gloucester, Cape May, Cumberland Counties CoC",Largely Suburban CoC,,,979,781,562,219,224
"Canton, Massillon, Alliance/Stark County CoC",Largely Suburban CoC,,,273,121,104,17,4
Cape Cod Islands CoC,Largely Suburban CoC,,,371,176,138,38,60
Carroll County CoC,Largely Suburban CoC,,,144,105,88,17,41
Cattaragus County CoC,Largely Rural CoC,,,33,26,26,0,1
Cecil County CoC,Largely Suburban CoC,,,126,77,59,18,14
Central Oregon CoC,Largely Rural CoC,,,880,637,212,425,115
Central Tennessee CoC,Largely Rural CoC,,,357,266,219,47,49
Central Virginia CoC,Largely Rural CoC,x,,78,54,40,14,5
"Champaign, Urbana, Rantoul/Champaign County CoC",Other Largely Urban CoC,,,151,81,79,2,10
Chapel Hill/Orange County CoC,Other Largely Urban CoC,,,131,103,76,27,19
"Charles, Calvert, St.Mary's Counties CoC",Largely Suburban CoC,,,306,228,132,96,67
"Charleston/Kanawha, Putnam, Boone, Clay Counties CoC",Largely Suburban CoC,,,293,236,234,2,50
Charleston/Low Country CoC,Largely Suburban CoC,,,403,351,223,128,86
Charlotte-Mecklenburg CoC,Major City CoC,x,,1742,1223,1027,196,235
Charlottesville CoC,Largely Rural CoC,x,,165,143,117,26,30
Chattanooga/Southeast Tennessee CoC,Largely Rural CoC,x,,463,367,202,165,87
Chester County CoC,Largely Suburban CoC,x,,528,386,374,12,19
Chicago CoC,Major City CoC,,,5290,3318,2064,1254,914
"Chico, Paradise/Butte County CoC",Largely Rural CoC,,,1266,1067,247,820,227
Cincinnati/Hamilton County CoC,Largely Suburban CoC,,,1082,793,762,31,69
"Citrus, Hernando, Lake, Sumter Counties CoC",Largely Suburban CoC,,,677,499,184,315,68
Clackamas County CoC,Largely Suburban CoC,x,x,471,385,178,207,175
Cleveland/Cuyahoga County CoC,Largely Suburban CoC,,,1618,1228,1122,106,212
Clinton County CoC,Largely Rural CoC,,,164,131,130,1,24
Colorado BoS Fremont County,Largely Rural CoC,x,,2302,1783,1085,698,665
Colorado BoS Mesa County,Largely Rural CoC,x,,2302,1783,1085,698,665
Colorado BoS Roaring Fork,Largely Rural CoC,x,,2302,1783,1085,698,665
Columbia-Boone County/Missouri Balance of State CoC,Largely Rural CoC,x,,1362,916,603,313,226
"Columbia, Greene Counties CoC",Largely Rural CoC,,,200,97,93,4,8
"Columbia, Hamilton, Lafayette, Suwannee Counties CoC",Largely Rural CoC,,,538,454,58,396,41
Columbia/Midlands CoC,Largely Suburban CoC,,,1215,980,705,275,277
Columbus-Muscogee CoC,Other Largely Urban CoC,,,278,217,165,52,20
Columbus/Franklin County CoC,Major City CoC,,,1907,1350,982,368,97
"Colusa, Glenn, Trinity Counties CoC",Largely Rural CoC,,,192,136,3,133,42
Connecticut Balance of State CoC,Largely Suburban CoC,,,2262,1626,1270,356,146
Cook County CoC,Largely Suburban CoC,x,,897,573,468,105,133
Cumberland/Allegany County CoC,Largely Suburban CoC,,,145,95,58,37,13
"Dakota, Anoka, Washington, Scott, Carver Counties",Largely Suburban CoC,,,686,372,185,187,105
"Dallas City & County, Irving CoC",Major City CoC,,,4538,3513,2071,1442,515
Daly/San Mateo County CoC,Largely Suburban CoC,,,1512,1111,272,839,318
"Davis, Woodland/Yolo County CoC",Largely Suburban CoC,,,655,521,124,397,163
"Dayton, Kettering/Montgomery County CoC",Largely Suburban CoC,,,681,545,496,49,28
"Dearborn, Dearborn Heights, Westland/Wayne County CoC",Largely Suburban CoC,,,222,90,73,17,12
Decatur/Macon County CoC,Other Largely Urban CoC,,,169,119,108,11,25
DeKalb County CoC,Largely Suburban CoC,,,375,261,64,197,36
Delaware Statewide CoC,Largely Suburban CoC,,,921,565,489,76,119
"Deltona, Daytona Beach/Volusia, Flagler Counties CoC",Largely Suburban CoC,,,875,574,103,471,78
Des Moines/Polk County CoC,Other Largely Urban CoC,,,681,558,466,92,95
Detroit CoC,Major City CoC,x,,1965,1400,1314,86,263
District of Columbia CoC,Major City CoC,x,x,6521,3875,3267,608,1374
Duluth/St.Louis County CoC,Largely Rural CoC,,,519,315,146,169,148
DuPage County CoC,Largely Suburban CoC,,,309,187,177,10,31
Durham City & County CoC,Other Largely Urban CoC,,,361,252,175,77,64
"East St. Louis, Belleville/St. Clair County CoC",Largely Suburban CoC,,,247,107,55,52,31
Eastern Pennsylvania CoC,Largely Rural CoC,,,1843,1083,758,325,127
Eaton County CoC,Largely Suburban CoC,,,114,3,3,0,0
El Dorado County CoC,Largely Suburban CoC,,,613,536,114,422,111
El Paso City and County CoC,Major City CoC,x,,809,527,344,183,111
Elizabeth/Union County CoC,Largely Suburban CoC,,,437,240,201,39,58
"Elmira/Steuben, Allegany, Livingston, Chemung, Schuyler Counties CoC",Largely Rural CoC,,,240,129,122,7,3
Erie City & County CoC,Largely Suburban CoC,,,356,255,249,6,34
"Eugene, Springfield/Lane County CoC",Other Largely Urban CoC,x,x,2165,1908,374,1534,783
Everett/Snohomish County CoC,Largely Suburban CoC,,,1116,779,272,507,405
Fairfax County CoC,Largely Suburban CoC,x,x,1034,508,419,89,213
Fall River CoC,Largely Suburban CoC,,,320,66,62,4,36
Fayetteville/Cumberland County CoC,Other Largely Urban CoC,,,329,222,12,210,122
Fayetteville/Northwest Arkansas CoC,Other Largely Urban CoC,x,,518,439,223,216,120
Flint/Genesee County CoC,Largely Suburban CoC,x,,450,288,240,48,49
Florence/Northwest Alabama CoC,Largely Rural CoC,,,390,383,182,201,21
"Fort Pierce/St. Lucie, Indian River, Martin Counties CoC",Largely Suburban CoC,,,1499,754,52,702,51
Fort Smith CoC,Largely Rural CoC,,,247,187,127,60,98
"Fort Walton Beach/Okaloosa, Walton Counties CoC",Largely Suburban CoC,,,399,319,114,205,215
Fort Worth/Arlington/Tarrant County CoC,Major City CoC,x,,2028,1597,1047,550,284
"Franklin, Essex Counties CoC",Largely Rural CoC,,,24,22,19,3,0
Frederick City & County CoC,Largely Suburban CoC,,,286,212,134,78,37
"Fredericksburg/Spotsylvania, Stafford Counties CoC",Largely Suburban CoC,,,221,132,96,36,30
Fresno/Madera County CoC,Major City CoC,x,x,2508,2267,214,2053,692
Ft Lauderdale/Broward County CoC,Largely Suburban CoC,,,2803,2341,1019,1322,856
"Ft Myers, Cape Coral/Lee County CoC",Largely Suburban CoC,,,372,257,129,128,86
Fulton County CoC,Largely Suburban CoC,,,632,400,330,70,68
Gadsden/Northeast Alabama CoC,Largely Rural CoC,,,224,189,62,127,25
Garrett County CoC,Largely Rural CoC,,,12,12,11,1,1
"Gastonia/Cleveland, Gaston, Lincoln Counties CoC",Largely Suburban CoC,,,324,236,164,72,58
Georgia Balance of State CoC,Largely Rural CoC,,,4183,2960,799,2161,284
Glendale CoC,Other Largely Urban CoC,,,243,162,30,132,60
"Glens Falls, Saratoga Springs/Saratoga, Washington, Warren, Hamilton Counties Co",Largely Suburban CoC,,,268,209,202,7,40
"Gloucester, Haverhill, Salem/Essex County CoC",Largely Suburban CoC,,,760,261,210,51,68
"Grand Rapids, Wyoming/Kent County CoC",Other Largely Urban CoC,,,759,435,419,16,113
"Grand Traverse, Antrim, Leelanau Counties CoC",Largely Rural CoC,,,168,122,118,4,38
Greater Kansas City Coalition to End Homelessness,Major City CoC,x,,1979,1392,1084,308,305
"Greenville, Anderson, Spartanburg/Upstate CoC",Largely Suburban CoC,,,1401,1086,669,417,305
Guam CoC,Largely Rural CoC,,,875,258,28,230,26
Guilford County CoC,Other Largely Urban CoC,x,,586,460,399,61,38
Gulfport/Gulf Coast Regional CoC,Largely Rural CoC,x,,296,237,46,191,19
Hagerstown/Washington County CoC,Largely Suburban CoC,,,249,202,139,63,38
Harford County CoC,Largely Suburban CoC,,,228,96,73,23,19
Harrisburg/Dauphin County CoC,Largely Suburban CoC,,,418,287,242,45,60
Hawaii Balance of State CoC,Largely Rural CoC,,,1995,1324,251,1073,550
"Hendry, Hardee, Highlands Counties CoC",Largely Rural CoC,,,398,242,0,242,179
Holland/Ottawa County CoC,Largely Suburban CoC,,,225,128,113,15,0
Honolulu CoC,Largely Suburban CoC,x,x,4417,3096,983,2113,1042
"Houston, Pasadena, Conroe/Harris, Ft. Bend, Montgomery, Counties CoC",Major City CoC,,,3938,2957,1343,1614,616
Howard County CoC,Largely Suburban CoC,,,201,98,55,43,31
Humboldt County CoC,Largely Rural CoC,,,1702,1578,190,1388,454
"Huntington/Cabell, Wayne Counties CoC",Largely Rural CoC,,,171,157,108,49,10
Huntsville/North Alabama CoC,Other Largely Urban CoC,,,464,340,253,87,94
Idaho Balance of State CoC,Largely Rural CoC,,,1602,948,324,624,170
Imperial County CoC,Largely Suburban CoC,,,1413,1120,96,1024,399
Indiana Balance of State CoC,Largely Rural CoC,,,3904,2628,2115,513,214
Indianapolis CoC,Major City CoC,,,1567,1155,1055,100,100
Iowa Balance of State CoC,Largely Rural CoC,,,1379,854,772,82,185
Ithaca/Tompkins County CoC,Largely Rural CoC,,,171,122,122,0,51
Jackson City & County CoC,Largely Rural CoC,,,113,90,77,13,7
"Jackson/Rankin, Madison Counties CoC",Largely Suburban CoC,x,,408,346,240,106,166
Jackson/West Tennessee CoC,Largely Rural CoC,,,959,514,66,448,51
"Jacksonville-Duval, Clay Counties CoC",Major City CoC,x,,1654,1365,857,508,285
"Jamestown, Dunkirk/Chautauqua County CoC",Largely Rural CoC,,,96,55,55,0,2
"Jefferson, Lewis, St. Lawrence Counties CoC",Largely Rural CoC,,,53,39,35,4,0
"Jersey City, Bayonne/Hudson County CoC",Largely Suburban CoC,,,890,722,458,264,226
"Joliet, Bolingbrook/Will County CoC",Largely Suburban CoC,,,278,187,144,43,18
"Joplin/Jasper, Newton Counties CoC",Largely Rural CoC,,,237,188,141,47,22
Kansas BoS Douglas County,Largely Rural CoC,x,,1056,787,558,229,84
Kentucky Balance of State CoC,Largely Rural CoC,,,2221,1588,996,592,182
Kingston/Ulster County CoC,Largely Rural CoC,,,432,167,130,37,22
Knoxville/Knox County CoC,Largely Suburban CoC,,,800,726,531,195,149
Lafayette/Acadiana CoC,Largely Rural CoC,,,360,279,129,150,75
Lake County CoC,Largely Rural CoC,,,408,345,10,335,221
Lake County/North Chicago,Largely Suburban CoC,x,,252,157,125,32,25
"Lakeland, Winterhaven/Polk County CoC",Largely Suburban CoC,,,563,374,260,114,77
Lakewood Township/Ocean County CoC,Largely Suburban CoC,,,305,179,151,28,38
Lancaster City & County CoC,Largely Suburban CoC,x,,422,246,234,12,12
"Lansing, East Lansing/Ingham County CoC",Other Largely Urban CoC,,,476,303,293,10,40
Las Vegas/Clark County CoC,Major City CoC,,,5530,5188,1896,3292,596
Lenawee County CoC,Largely Rural CoC,,,123,60,57,3,6
Lexington-Fayette County CoC,Other Largely Urban CoC,,,787,676,665,11,103
Lincoln CoC,Other Largely Urban CoC,,,449,279,235,44,90
Little Rock/Central Arkansas CoC,Other Largely Urban CoC,,,1066,906,355,551,289
Livingston County CoC,Largely Suburban CoC,,,89,40,40,0,1
Long Beach CoC,Major City CoC,,,1894,1700,471,1229,624
Los Angeles City & County CoC,Major City CoC,,,56257,47810,6966,40844,14906
Loudoun County CoC,Largely Suburban CoC,,,167,124,53,71,37
Louisiana Balance of State CoC,Largely Suburban CoC,,,593,503,286,217,110
Louisville-Jefferson County CoC,Major City CoC,,,1071,809,691,118,194
Lowell CoC,Largely Suburban CoC,,,784,221,205,16,26
"Lower Merion, Norristown, Abington/Montgomery County CoC",Largely Suburban CoC,,,246,115,96,19,27
Lynn CoC,Largely Suburban CoC,,,1035,78,73,5,43
Madison County CoC,Largely Suburban CoC,,,101,57,37,20,4
Madison/Dane County CoC,Other Largely Urban CoC,x,,578,354,279,75,89
Maine Statewide CoC,Largely Rural CoC,,,2106,1232,1140,92,211
Manchester CoC,Other Largely Urban CoC,,,461,274,223,51,35
Marietta/Cobb County CoC,Largely Suburban CoC,,,451,306,190,116,58
Marin County CoC,Largely Suburban CoC,x,x,1034,887,196,691,250
"Marquette, Alger Counties CoC",Largely Rural CoC,,,53,30,30,0,2
Massachusetts Balance of State CoC,Largely Suburban CoC,,,1918,505,324,181,49
McHenry County CoC,Largely Suburban CoC,x,,159,93,92,1,16
"Medford, Ashland/Jackson County CoC",Largely Suburban CoC,,,712,602,263,339,180
Memphis/Shelby County CoC,Major City CoC,,,1325,761,703,58,74
Mendocino County CoC,Largely Rural CoC,,,785,681,152,529,118
Merced City & County CoC,Largely Suburban CoC,,,608,419,144,275,174
Metro Denver CoC,Major City CoC,x,x,5755,4353,3425,928,1124
Miami-Dade County CoC,Major City CoC,,,3472,2312,1304,1008,321
Michigan Balance of State CoC,Largely Rural CoC,,,1245,624,518,106,57
Mid-Shore Regional CoC,Largely Rural CoC,,,164,81,63,18,16
Mid-Willamette Valley Homeless Alliance,Largely Rural CoC,x,x,7103,4728,1300,3428,1471
Middlesex County CoC/Coming Home,Largely Suburban CoC,x,,620,361,226,135,108
Milwaukee City & County CoC,Major City CoC,,,885,625,519,106,73
Minneapolis/Hennepin County CoC,Major City CoC,x,,3400,2057,1457,600,665
Mississippi Balance of State CoC,Largely Rural CoC,,,480,380,193,187,31
Mobile City & County/Baldwin County CoC,Other Largely Urban CoC,,,505,329,150,179,38
Monmouth County CoC,Largely Suburban CoC,,,359,208,156,52,58
Monroe City & County CoC,Largely Suburban CoC,,,167,91,91,0,3
Monroe County CoC,Largely Rural CoC,,,501,469,267,202,36
Monroe/Northeast Louisiana CoC,Largely Rural CoC,,,188,87,70,17,20
Montana Statewide CoC,Largely Rural CoC,,,1357,947,656,291,194
Montgomery City & County CoC,Other Largely Urban CoC,,,330,228,171,57,59
Montgomery County CoC,Largely Suburban CoC,x,x,647,441,366,75,11
Moorhead/West Central Minnesota CoC,Largely Rural CoC,,,216,97,96,1,14
Morris County CoC,Largely Suburban CoC,,,388,244,202,42,65
Murfreesboro/Rutherford County CoC,Largely Suburban CoC,,,384,327,173,154,41
"Myrtle Beach, Sumter City & County CoC",Largely Rural CoC,,,1153,901,278,623,229
Napa City & County CoC,Other Largely Urban CoC,,,322,270,125,145,144
Naples/Collier County CoC,Largely Suburban CoC,,,498,330,254,76,39
Nashua/Hillsborough County CoC,Largely Suburban CoC,,,266,129,126,3,14
Nashville/Davidson County CoC,Major City CoC,x,,1986,1802,1219,583,458
"Nassau, Suffolk Counties CoC",Largely Suburban CoC,x,,3843,1171,1125,46,53
Nebraska Balance of State CoC,Largely Rural CoC,,,506,306,289,17,11
Nevada Balance of State CoC,Largely Rural CoC,,,383,325,86,239,9
Nevada County CoC,Largely Rural CoC,x,x,415,342,119,223,111
New Bedford CoC,Largely Suburban CoC,,,433,229,178,51,44
New Hampshire Balance of State CoC,Largely Rural CoC,,,669,409,318,91,139
New Orleans/Jefferson Parish CoC,Major City CoC,,,1179,1049,619,430,146
New York Balance of State Continuum of Care,Largely Rural CoC,,,168,76,72,4,14
New York City CoC,Major City CoC,,,78604,35427,31805,3622,5193
Newark/Essex County,Largely Suburban CoC,x,,2235,1360,1035,325,248
"Newburgh, Middletown/Orange County CoC",Largely Suburban CoC,,,589,251,200,51,54
"Newport News, Hampton/Virginia Peninsula CoC",Other Largely Urban CoC,,,427,304,252,52,53
"Norfolk, Chesapeake, Suffolk/Isle of Wight, Southampton Counties CoC",Largely Suburban CoC,,,700,493,409,84,77
Norman/Cleveland County CoC,Largely Suburban CoC,x,,347,299,84,215,276
North Carolina Balance of State CoC,Largely Rural CoC,,,2989,2213,1456,757,267
North Central Florida,Largely Rural CoC,x,,804,675,198,477,247
North Central Oklahoma CoC,Largely Rural CoC,,,178,125,118,7,3
North Dakota Statewide CoC,Largely Rural CoC,,,557,377,374,3,73
Northeast Minnesota CoC,Largely Rural CoC,,,90,47,19,28,4
Northeast Oklahoma CoC,Largely Rural CoC,,,228,123,69,54,21
Northern Colorado CoC,Largely Rural CoC,x,x,2302,1783,1085,698,665
Northern Mariana Islands CoC,Largely Rural CoC,,,1807,423,18,405,22
Northwest Minnesota CoC,Largely Rural CoC,,,268,124,116,8,27
Northwest North Carolina CoC,Largely Rural CoC,,,417,217,111,106,17
"Norton Shores, Muskegon City & County CoC",Largely Suburban CoC,,,136,87,71,16,14
"Oakland, Berkeley/Alameda County CoC",Major City CoC,,,8022,7498,1213,6285,2103
Ocala/Marion County CoC,Largely Suburban CoC,,,475,365,188,177,144
Ohio Balance of State CoC,Largely Rural CoC,,,3479,2102,1392,710,281
Oklahoma Balance of State CoC,Largely Rural CoC,,,279,225,84,141,73
Oklahoma City CoC,Major City CoC,,,1273,1065,692,373,255
"Omaha, Council Bluffs CoC",Major City CoC,,,1410,1130,1084,46,321
"Orlando/Orange, Osceola, Seminole Counties CoC",Largely Suburban CoC,,,2010,1265,932,333,353
"Overland Park, Shawnee/Johnson County CoC",Largely Suburban CoC,,,189,109,70,39,29
"Oxnard, San Buenaventura/Ventura County CoC",Other Largely Urban CoC,,,1669,1472,232,1240,318
"Palm Bay, Melbourne/Brevard County CoC",Largely Suburban CoC,,,815,604,230,374,195
"Panama City/Bay, Jackson Counties CoC",Largely Rural CoC,,,488,454,116,338,34
Pasadena CoC,Other Largely Urban CoC,,,542,465,144,321,264
Pasco County CoC,Largely Suburban CoC,,,894,685,74,611,186
Paterson/Passaic County CoC,Largely Suburban CoC,,,391,287,170,117,91
"Pensacola/Escambia, Santa Rosa Counties CoC",Largely Suburban CoC,,,518,473,304,169,47
"Peoria, Pekin/Fulton, Tazewell, Peoria, Woodford Counties CoC",Largely Suburban CoC,,,285,205,194,11,45
Philadelphia CoC,Major City CoC,,,5735,3752,2779,973,1264
Phoenix/Mesa/Maricopa County Regional CoC,Major City CoC,x,,6614,4948,1763,3185,906
Pikes Peak CoC,Major City CoC,x,x,1562,1127,718,409,317
"Pittsburgh, McKeesport, Penn Hills/Allegheny County CoC",Largely Suburban CoC,,,774,536,488,48,102
"Pittsfield/Berkshire, Franklin, Hampshire Counties CoC",Largely Suburban CoC,,,546,362,328,34,48
Placer County,Largely Suburban CoC,x,,617,493,202,291,216
Pontiac/Royal Oak/Oakland County CoC,Largely Suburban CoC,x,,425,247,219,28,41
"Portage, Kalamazoo City & County CoC",Other Largely Urban CoC,,,702,440,284,156,76
"Portland, Gresham/Multnomah County CoC",Major City CoC,,,4015,3698,1673,2025,1763
Portsmouth CoC,Other Largely Urban CoC,,,119,80,69,11,8
Poughkeepsie/Dutchess County CoC,Largely Suburban CoC,,,533,269,259,10,23
Prince George's County CoC,Largely Suburban CoC,,,447,200,127,73,44
Prince William County CoC,Largely Suburban CoC,,,280,117,80,37,19
Provo/Mountainland CoC,Largely Suburban CoC,x,,161,113,49,64,22
Puerto Rico Balance of Commonwealth CoC,Largely Suburban CoC,,,1345,1202,320,882,361
Punta Gorda/Charlotte County CoC,Largely Suburban CoC,,,156,131,64,67,48
"Quincy, Brockton, Weymouth, Plymouth City and County CoC",Largely Suburban CoC,,,1088,383,370,13,132
Racine City & County CoC,Largely Suburban CoC,,,200,148,136,12,10
Raleigh/Wake County CoC,Major City CoC,,,970,680,462,218,115
Reading/Berks County CoC,Largely Suburban CoC,,,597,455,445,10,35
"Redding/Shasta, Siskiyou, Lassen, Plumas, Del Norte, Modoc, Sierra Counties CoC",Largely Rural CoC,,,1349,1144,363,781,304
"Reno, Sparks/Washoe County CoC",Other Largely Urban CoC,x,,1256,1101,875,226,74
Rhode Island Statewide CoC,Largely Suburban CoC,,,1055,730,663,67,176
Richmond/Contra Costa County CoC,Largely Suburban CoC,x,x,2295,1976,477,1499,454
"Richmond/Henrico, Chesterfield, Hanover Counties CoC",Largely Suburban CoC,x,,497,382,217,165,74
Riverside City & County CoC,Largely Suburban CoC,x,x,2811,2522,490,2032,786
Roanoke City & County/Salem CoC,Largely Suburban CoC,x,,319,244,229,15,56
"Rochester, Irondequoit, Greece/Monroe County CoC",Largely Suburban CoC,,,849,606,571,35,86
Rochester/Southeast Minnesota CoC,Largely Rural CoC,,,452,210,168,42,38
"Rock Island, Moline/Northwestern Illinois CoC",Largely Rural CoC,,,211,137,127,10,2
"Rockford/Winnebago, Boone Counties CoC",Largely Suburban CoC,x,,403,257,212,45,28
Rockland County CoC,Largely Suburban CoC,,,182,145,102,43,36
Sacramento City & County CoC,Major City CoC,x,x,5561,4429,1096,3333,1412
Saginaw City & County CoC,Largely Suburban CoC,,,364,186,174,12,16
Saint Johns County CoC,Largely Suburban CoC,x,,356,236,52,184,14
Saint Paul/Ramsey County CoC,Other Largely Urban CoC,,,1579,1002,752,250,376
Salem County CoC,Largely Suburban CoC,,,29,8,8,0,1
"Salinas/Monterey, San Benito Counties CoC",Largely Rural CoC,,,2704,2037,342,1695,614
Salt Lake City & County CoC,Largely Suburban CoC,,,1844,1318,1125,193,367
San Antonio/Bexar County CoC,Major City CoC,,,2872,2066,887,1179,330
San Bernardino City & County CoC,Largely Suburban CoC,,,2607,2119,286,1833,723
San Diego City and County CoC,Major City CoC,,x,8102,6683,2425,4258,1583
San Francisco CoC,Major City CoC,,,8035,7404,2250,5154,2855
San Jose/Santa Clara City & County CoC,Major City CoC,,,9706,8785,1106,7679,2353
San Luis Obispo County CoC,Largely Suburban CoC,,,1483,1261,173,1088,261
"Santa Ana, Anaheim/Orange County CoC",Largely Suburban CoC,,,6860,5310,1745,3565,2471
Santa Fe City,Largely Rural CoC,x,,1717,1240,597,643,719
Santa Maria/Santa Barbara County CoC,Largely Suburban CoC,,,1803,1435,344,1091,401
"Santa Rosa, Petaluma/Sonoma County CoC",Largely Suburban CoC,,,2951,2672,741,1931,653
"Sarasota, Bradenton/Manatee, Sarasota Counties CoC",Largely Suburban CoC,,,1135,975,584,391,241
Savannah/Chatham County CoC,Other Largely Urban CoC,,,686,578,347,231,182
Schenectady City & County CoC,Largely Suburban CoC,,,372,231,209,22,24
Scranton/Lackawanna County CoC,Largely Suburban CoC,,,186,142,133,9,12
Seattle/King County CoC,Major City CoC,,,11199,8748,3583,5165,2034
"Shreveport, Bossier/Northwest Louisiana CoC",Other Largely Urban CoC,,,292,218,158,60,41
"Sioux City/Dakota, Woodbury Counties CoC",Other Largely Urban CoC,,,255,162,155,7,21
Slidell/Southeast Louisiana CoC,Largely Suburban CoC,,,215,193,131,62,18
Somerset County CoC,Largely Suburban CoC,,,301,197,191,6,7
Somerville CoC,Largely Suburban CoC,,,127,95,85,10,23
South Central Illinois CoC,Largely Rural CoC,,,94,59,32,27,3
South Dakota Statewide CoC,Largely Rural CoC,,,995,725,504,221,81
South-Southeast Puerto Rico CoC,Largely Suburban CoC,,,1190,1139,191,948,311
Southeast Arkansas CoC,Largely Rural CoC,,,75,35,35,0,0
Southeastern Oklahoma Regional CoC,Largely Rural CoC,,,293,197,164,33,20
Southern Illinois CoC,Largely Rural CoC,,,294,178,134,44,18
Southwest Minnesota CoC,Largely Rural CoC,,,88,30,24,6,3
Southwest Oklahoma Regional CoC,Largely Rural CoC,,,158,90,71,19,9
Spokane City and County CoC,Other Largely Urban CoC,x,,1309,1007,711,296,231
Springfield CoC,Largely Suburban CoC,x,,2443,373,331,42,69
"Springfield/Greene, Christian, Webster Counties CoC",Other Largely Urban CoC,,,492,335,254,81,107
Springfield/Sangamon County CoC,Other Largely Urban CoC,,,284,204,179,25,57
"St. Charles City & County, Lincoln, Warren Counties CoC",Largely Suburban CoC,,,438,237,143,94,18
"St. Clair Shores, Warren/Macomb County CoC",Largely Suburban CoC,,,265,193,175,18,12
St. Cloud/Central Minnesota CoC,Largely Rural CoC,,,679,332,174,158,64
"St. Joseph/Andrew, Buchanan, DeKalb Counties CoC",Other Largely Urban CoC,,,255,169,136,33,79
St. Louis City/St. Louis County CoCs,Other Largely Urban CoC,x,,1518,1027,950,77,201
St. Louis County CoC,Largely Suburban CoC,,,487,281,257,24,29
"St. Petersburg, Clearwater, Largo/Pinellas County CoC",Largely Suburban CoC,,,2415,2034,1209,825,718
St.Louis City CoC,Other Largely Urban CoC,,,1031,746,693,53,172
Stockton/San Joaquin County CoC,Other Largely Urban CoC,,,2631,2102,554,1548,704
Sullivan County CoC,Largely Rural CoC,,,162,59,59,0,0
"Syracuse, Auburn/Onondaga, Oswego, Cayuga Counties CoC",Largely Suburban CoC,,,732,552,539,13,30
"Tacoma, Lakewood/Pierce County CoC",Largely Suburban CoC,,,1486,1111,520,591,325
Tallahassee/Leon County CoC,Other Largely Urban CoC,x,,966,751,669,82,147
Tampa/Hillsborough County CoC,Major City CoC,,,1650,1194,522,672,260
Tehama County CoC,Largely Rural CoC,,,288,231,43,188,123
Tennessee Valley,Largely Rural CoC,x,,515,376,105,271,39
Texas Balance of State CoC - Abilene,Largely Rural CoC,x,,8072,6180,1750,4430,570
Toledo/Lucas County CoC,Other Largely Urban CoC,,,611,361,349,12,48
Topeka/Shawnee County CoC,Other Largely Urban CoC,,,441,329,264,65,158
Trenton/Mercer County CoC,Largely Suburban CoC,,,448,324,245,79,68
Troy/Rensselaer County CoC,Largely Suburban CoC,,,199,116,106,10,9
Tucson/Pima County CoC,Major City CoC,x,,1372,1015,654,361,345
Tulsa City & County CoC,Major City CoC,,,1188,939,675,264,225
"Turlock, Modesto/Stanislaus County CoC",Largely Suburban CoC,,,1923,1514,499,1015,260
Tuscaloosa City & County CoC,Other Largely Urban CoC,,,44,27,27,0,0
Upper Cumberland CoC,Largely Rural CoC,,,273,204,145,59,21
"Upper Darby, Chester, Haverford/Delaware County CoC",Largely Suburban CoC,,,400,223,175,48,21
Utah Balance of State CoC,Largely Suburban CoC,,,793,490,342,148,104
"Utica, Rome/Oneida, Madison Counties CoC",Largely Rural CoC,,,168,121,110,11,6
Vallejo/Solano County CoC,Other Largely Urban CoC,,,1151,1072,148,924,169
Vancouver/Clark County CoC,Largely Suburban CoC,,,958,506,220,286,152
Vermont Balance of State CoC,Largely Rural CoC,,,780,453,389,64,105
Virgin Islands CoC,Largely Rural CoC,,,314,314,82,232,105
Virginia Balance of State - Petersburg,Largely Rural CoC,x,,761,389,289,100,24
Virginia Balance of State - Waynesboro,Largely Rural CoC,x,,761,389,289,100,24
Virginia Beach CoC,Major City CoC,,,260,190,136,54,38
"Visalia/Kings, Tulare Counties CoC",Other Largely Urban CoC,,,1064,929,188,741,304
Waco/McLennan County CoC,Largely Rural CoC,,,193,134,65,69,33
"Warren, Sussex, Hunterdon Counties CoC",Largely Suburban CoC,,,334,240,212,28,30
Washington Balance of State CoC,Largely Rural CoC,,,5509,3834,1789,2045,1299
Washington County CoC,Largely Suburban CoC,x,x,530,396,194,202,122
Washtenaw County,Largely Suburban CoC,x,,273,193,181,12,58
Watsonville/Santa Cruz City & County CoC,Largely Suburban CoC,x,x,2167,1748,271,1477,354
"Wayne, Ontario, Seneca, Yates Counties CoC",Largely Rural CoC,,,205,136,135,1,80
West Central Illinois CoC,Largely Rural CoC,,,68,36,34,2,3
West Palm Beach/Palm Beach County CoC,Largely Suburban CoC,x,,1397,1133,210,923,215
West Virginia Balance of State CoC,Largely Rural CoC,,,797,654,484,170,79
Western Pennsylvania CoC,Largely Rural CoC,,,727,464,433,31,17
Western Virginia CoC,Largely Rural CoC,x,,342,233,205,28,41
"Wheeling, Weirton Area CoC",Largely Rural CoC,,,136,102,93,9,13
"Wichita Falls/Wise, Palo Pinto, Wichita, Archer Counties CoC",Largely Rural CoC,,,243,217,158,59,11
Wichita/Sedgwick County CoC,Other Largely Urban CoC,,,593,426,369,57,20
"Wicomico, Somerset, Worcester Counties CoC",Largely Rural CoC,,,275,198,161,37,41
"Wilkes-Barre, Hazleton/Luzerne County CoC",Largely Suburban CoC,,,164,97,90,7,2
"Wilmington/Brunswick, New Hanover, Pender Counties CoC",Largely Suburban CoC,,,431,342,184,158,49
Winston-Salem/Forsyth County CoC,Other Largely Urban CoC,x,,454,380,356,24,68
Wisconsin Balance of State CoC,Largely Rural CoC,,,2875,1418,1329,89,254
Worcester City & County CoC,Largely Suburban CoC,,,1593,662,500,162,63
Wyoming Statewide CoC,Largely Rural CoC,,,548,437,329,108,64
Wyoming Statewide CoC,Largely Rural CoC,,,548,437,329,108,64
"Yonkers, Mount Vernon/Westchester County CoC",Largely Suburban CoC,,,1812,607,575,32,84
York City & County CoC,Largely Suburban CoC,,,321,177,147,30,13
Youngstown/Mahoning County CoC,Other Largely Urban CoC,,,148,116,107,9,14
Yuba City & County/Sutter County CoC,Largely Suburban CoC,,,721,545,105,440,206
